NO ./assets/grass.xpm
SO ./assets/cobble.xpm
WE ./assets/espace.xpm
EA ./assets/brick.xpm
F 142,95,39
C 15,99,153

        1111111111111111111111111 111111
        1000000000110000000000001 100101
        101100000111000000000S001 101001
        1001000000000000000000001 110001      
111111111011000001110000000000001 111111
100000000011000001110111111111111
11110111111111011100000010001
11110111111111011101000010001  11
11000000110101011100000010001  11
10000000000000001100000010001
10000000000000001101010010001
110000011101010111110111100111  
11110111 1110101 101111010001
11111111 1111111 111111111111 
