NO ./assets/brick.xpm
SO ./assets/espace.xpm
WE ./assets/grass.xpm
EA ./assets/cobble.xpm
F 142,95,39
C 15,99,153

1111111111111111111111111111111111
1000000000110110000000000000000111
1011000001111010000000000000000001
1001000000011100000000000000000011
1111111110111111000000000000000111
1000000000111010001000100000111111
1111011111111111100000000000010001
111101111111110111N001000000000001
1100000011010101110000000000000001
1000000000000000110000000000000001
1000000000000000110001000000010001
1100000111010100000001000100010011
11110111 1101011000000011100010001
11111111 1111111111111111 11111111
