NO ./assets/greystone.xpm
SO ./assets/redbrick.xpm
./assets/mossy.xpm
EA ./assets/mossy.xpm 
F 142,95,39
C 15,99,153

        1111111111111111111111111 111111
        1000000000110000000000001 100101
        1011000001110000000000001 101001
        1001000000000000000E00001 110001      
111111111011000001110000000000001 111111
100000000011000001110111111111111
11110111111111011100000010001
111101111111110111010E0010001  11
11000000110101011100000010001  11
10000000000000001100000010001
10000000000000001101010010001
110000011101010111110111100111  
11110111 1110101 101111010001
11111111 1111111 111111111111 
